   WE                            Textures/e.xpm
NO      Textures/a.xpm				    



SO Textures/c.xpm		  

F   69, 222, 199

EA Textures/d.xpm         

fgff

C 218, 									234, 235

111111111111111
10S001000000001
100010001111001
100001001001001
100000000001001
111111111111111