   WE                            Textures/e.xpm
NO      Textures/dz.xpm				    



SO Textures/richard.xpm		  

F   69, 222, 199

EA Textures/ma.xpm         
C 218, 									234,      235

1111111111111111111111
10S00100000000000000001
10001000111100111111101
100001001001001     101
100000000001001     10111111111
111111111101111     10000000001
         101         11111111101
11111111110111111111111111110001    
111111111111111111100111111000001    
1111111111111111100000000000000001    
111111111111111111100111111000001
11111111111111111111111111110001 
11111111111111111111111111111111           