   WE                            Textures/e.xpm
NO      Textures/a.xpm				    



SO Textures/c.xpm

EA Textures/d.xpm  

F 18,53,25
C 153,204,255

111111111111
100001000001
1111000S0001
100010000001
100100000001
100000000001
111111111111