   WE                            Textures/e.xpm
NO      Textures/a.xpm				    



SO Textures/c.xpm

EA Textures/d.xpm  

F 155,155,155
C 176,224,230
1111111111111111111
10W1001001001000001
1011000001000001001
1001001001111101111
1001111000001001001
1000000000000001001
1001111111111001001
1111000000000001011
1000000001000000001
1111111111111111111