
NO                   Textures/;O.xpm
				SO           Textures/dz.xpm                     

	   WE                    Textures/richard.xpm


	  EA Textures/tom.xpm

	                   F            255,   211, 1              
		        C 1,1,               2

111
1N1
101111  11111111     11111
100001  10000001    110001
1111011110000001   11000001
   100000000000111110011000111
   100000000000000000000000011
   1111111111111110111110111
                 101   101
                 111111111