
NO Files/a.xpm
SO Files/a.xpm
WE Files/a.xpm
EA Files/a.xpm

F 50,50,50
C 60,60,60

11111111
10000111
1100N001
10000101
11001011
10001101
10001101
11111111