
NO Files/a.xpm
SO Files/b.xpm
WE Files/c.xpm
EA Files/d.xpm

C 51,102,255
F 0,153,0

1111111 1111111
100000111000001
100000111000001
100N00000000001
100000111000001
1000001 1000001
1111111 1111111