
NO Files/a.xpm
SO Files/a.xpm
WE Files/a.xpm
EA Files/a.xpm

C 51,102,255
F 0,153,0

11111111111111111111111111111111111111111111111111111111
10S01100001000000000000000000000000000000000000000000001
10001100000000001111110011111111111111111111111111111111
1000110000000000110001001
1000000000100000000001001
1111111111111111111111111